001111222
000011222
003411122
033445552
333444555
633344558
667774588
666778888
666777788
28......1
1....63..
.......4.
...368.7.
....8....
.741.2...
.5.......
..79....4
3......1.
