001111222
000011222
003411122
033445552
333444555
633344558
667774588
666778888
666777788
28......1
1457.63.2
698....4.
...3.897.
46..8...3
.731.2..5
.5......6
..79....4
3......17
